1111111111111111111
1000000000000000001
1010111111111111111
1010100000000000001
1110111110010000001
101000000001000P001
1001111000010000001
1000000000000000001
1111111111111111111
